001111222
000011222
003411122
033445552
333444555
633344558
667774588
666778888
666777788
.........
.........
.........
.........
.........
.........
.........
.........
.........
.........